#######
#     #
# $$  #
#   ###
# #   #
#   ###
#@  ###
#   .##
## $..#
 ######